# viridian_forest
# Generated by map_editor.py

[header]
id|viridian_forest
width|54
height|69
background|assets/tilesets/route_2/viridian_forest.png
background_overlay|assets/tilesets/route_2/viridian_forest_overlay.png
music|assets/audio/1-04. New Bark Town_.mp3

[tiles]
######################################################
######################################################
######################################################
######################################################
######################################################
###########.............###........................###
###########.ppppppppppp.###........................###
###########.ppppppppppp.###........................###
###########.ppppppppppp.###.....###############....###
####...####.ppp.....ppp.###.....###############....###
####ppp####.ppp.....ppp.###.....###############....###
####ppp####.....###.....###.....###############....###
####..#####TTTTT###TTTTT###TTTTT###############....###
###TTTTT###TTTTT###TTTTT###TTTTT###############....###
###TTTTT###TTTTT###TTTTT###TTTTT###############....###
###TTTTT###TTTTT###TTTTT###TTTTTTTTTTT.............###
###TTTTT###TTTTT###TTTTT###TTTTTTTTTTT..ppp........###
###TTTTT###TTTTT###TTTTT###TTTTTTTTTTT..ppp........###
###TTTTT###TTTTT###TTTTT###TTTTTTTTTTT..ppp..#########
###TTTTT###TTTTT###TTTTT###TTTTTTTTTT...ppp..#########
###TTTTT###TTTTT###TTTTT###TTTTTT######.ppp..#########
###TTTTT###TTTTT###TTTTT###...TTT######.ppp..#########
###TTTTT###TTTTT###.....###......######.ppp..#########
###TTTTT###TTTTT###..ppppppppppp.######.ppp..#########
###TTTTT###TTTTT#####ppppppppppp.######.ppp..#########
###TTTTT###TTTTT#####ppppppppppp.######.ppp........###
###TTTTT###TTTTTTT#####################.ppp#.......###
###TTTTT...TTTTTTT#####################.ppppp......###
###...............#####################.ppppp......###
###......#........#####################TTTT........###
###...............#####################TTTTT###....###
###.....................###############TTTTT###....###
###.....................###############TTTTT###....###
###.....................###############TTTTT###....###
##################......###############TTTTT###....###
##################......###############TTTTT###....###
#######################################TTTTT###....###
#######################################TTTTT###....###
#######################################TTTTT###....###
###TTTTTTTTTTTTTTT#####################TTTTT###....###
###TTTTTTTTTTTTTTT#####################TTTTT###....###
###TTTTTTTTTTTTTTT#####################TTTTT###....###
###TTTTTTTTTTTTTTT#####################TTTTT###....###
###TTTTTTTTTTTTTTTTTTTTTTTTTTTTTT######TTTT........###
############TTTTTTTTTTTTTTTT#..TT######TTT.........###
############TTTTTTTTTTTTTTTT...TT######TTT.........###
############..TTT#########TT...TT######TTT...#########
############..TTT#########TT...TT######TTT...#########
############..TTT#########TT...TT######TTT...#########
############..TTT#########TT...TT######TTT...#########
############..TTT#########TT...TT######TTT...#########
############..TTT#########TT...TT######TTT...#########
############..TTT#########TT...TT######TTT...#########
############..TTT#########TT...TT######TTT...#########
############..TTT#########TT...TT######TTT...#########
###TTTTTTTTT..TTTTTTTTTTTTTT###TTTTTTTTTTT...TTTTTT###
###TTTTTTTTT..TTTTTTTTTTTTTT###TTTTTTTTTTT...TTTTTT###
###TTTTTTTTT...TTTTTTTTTTTT.###.TTTTTTTTT...TTTTTTT###
###TTTTTTTTT....TTTTTTTTTT.......TTTTTTT....TTTTTTT###
###TTTTTTTT....pppppppppppp............#....TTTTTTT###
###TTTTTTTT....pppppppppppp....#...........TTTTTTTT###
###TTTTTTTT....pppppppppppp.ppp............TTTTTTTT###
###########################.ppp..#####################
############################ppp#######################
######################################################
######################################################
######################################################
######################################################
######################################################

[warps]
# Format: fromX|fromY|targetMapId|targetX|targetY
28|63|route_2_gate_1|7|2
29|63|route_2_gate_1|7|2
30|63|route_2_gate_1|7|2
4|9|route_2_gate_2|7|10
5|9|route_2_gate_2|7|10
6|9|route_2_gate_2|7|10

[encounters]
# Format: speciesId|minLevel|maxLevel|weight
7|6|8|30
10|6|9|25
13|7|10|25
16|7|10|20

[npcs]
# Format: id|name|type|x|y|facing|sightRange|dialogue|sprite|party
# Dialogue supports inline stages or dialogue:path to an external .npcdialogue file
forest_trainer1|Bug Collector Oda|trainer|10|28|down|8|dialogue:assets/data/dialogue/route_2/forest_trainer1.npcdialogue|bug_catcher|7:8,10:8
forest_trainer2|Forager Signe|trainer|47|30|right|4|dialogue:assets/data/dialogue/route_2/forest_trainer2.npcdialogue|girl|13:9,16:9
forest_trainer3|Lost Senior|trainer|36|61|up|8|dialogue:assets/data/dialogue/route_2/forest_trainer3.npcdialogue|schoolboy|10:10,13:10
